0 50 93 184 197 153 208 276 326 395 402 452 454 486 497 509 521 469 549 555 610 671 748 
0 0 43 134 147 0 158 226 276 345 352 402 404 436 447 459 471 419 499 505 560 621 698 
0 0 0 91 0 0 115 0 0 0 0 0 0 0 0 0 0 0 0 0 0 0 0 
0 0 0 0 0 0 0 0 0 0 0 0 0 0 0 0 0 0 0 0 0 0 0 
0 0 0 0 0 0 0 79 129 198 205 255 257 289 300 312 324 272 352 358 413 474 551 
0 0 0 0 0 0 0 0 0 0 0 0 0 0 0 0 0 0 0 0 0 0 0 
0 0 0 0 0 0 0 0 0 0 0 0 0 0 0 0 0 0 0 0 0 0 0 
0 0 0 0 0 0 0 0 0 0 0 0 0 0 0 0 0 0 0 0 0 0 0 
0 0 0 0 0 0 0 0 0 69 76 126 128 160 171 183 195 143 223 229 284 345 422 
0 0 0 0 0 0 0 0 0 0 7 57 59 91 102 114 126 0 154 160 215 276 353 
0 0 0 0 0 0 0 0 0 0 0 0 52 84 95 107 119 0 147 153 208 269 346 
0 0 0 0 0 0 0 0 0 0 0 0 0 0 0 0 0 0 0 0 0 0 0 
0 0 0 0 0 0 0 0 0 0 0 0 0 32 43 55 67 0 0 101 156 217 294 
0 0 0 0 0 0 0 0 0 0 0 0 0 0 11 23 35 0 0 69 124 185 0 
0 0 0 0 0 0 0 0 0 0 0 0 0 0 0 12 0 0 0 0 113 0 0 
0 0 0 0 0 0 0 0 0 0 0 0 0 0 0 0 0 0 0 0 0 0 0 
0 0 0 0 0 0 0 0 0 0 0 0 0 0 0 0 0 0 0 34 0 150 0 
0 0 0 0 0 0 0 0 0 0 0 0 0 0 0 0 0 0 0 0 0 0 0 
0 0 0 0 0 0 0 0 0 0 0 0 0 0 0 0 0 0 0 0 0 0 0 
0 0 0 0 0 0 0 0 0 0 0 0 0 0 0 0 0 0 0 0 0 0 0 
0 0 0 0 0 0 0 0 0 0 0 0 0 0 0 0 0 0 0 0 0 0 0 
0 0 0 0 0 0 0 0 0 0 0 0 0 0 0 0 0 0 0 0 0 0 0 
0 0 0 0 0 0 0 0 0 0 0 0 0 0 0 0 0 0 0 0 0 0 0 
